##########
#b-------#
#--------#
#---@----#
#--------#
#--------#
#--------#
#--------#
#--------#
##########
