---------------------
---#----#----#-----#-
----#---#-----#--#---
-----#-#-------#-----
----------------#----
--#--#########-------
---#--#--------------
----#--#---#-#-#-----
-----#--#-----#------
------#------#-------
-------#-------------
-------------#--####-
--#----#------#------
---#----#------#-----
----#--#--------#----
-----#-----------#---
---------------------
