------------
------------
--########--
--#---#-----
--#---#-----
--#-###-----
------------
------------

