##########
#--------#
#--#####-#
#-----#--#
#-----#--#
#-----#--#
#--------#
##########
