####################
#--b--#------------#
#----#-------------#
#---#------#-------#
#--#--------#----#-#
#-#----------#--#--#
#-------------#----#
#-----#-#----------#
#----#---#---------#
#--##-----#--------#
#--#-------#-------#
#--#---------------#
#--#---------------#
#--#---------------#
#--#----########---#
#------#-----------#
#-----#------------#
#----#-------------#
#---#--------------#
####################
