--b--------------------#--------------#
-------#---------------#--------------#
-------#---------------#--------------#
-------#---########################---#
-------#------------------------------#
-------#--######################------#
-------#---------------#--------------#
-------#---------------#--------------#
-------#---------------#--------------#
-------#---------------#--------------#
############################----------#
--------------------------------------#
---------------#----------------------#
---------------#----------------------#
---------------#----------------------#
---#-----#-----#----------------------#
---#-----#-----#----------------------#
---#-----#-----#----------------------#
---#-----#-----#----------------------#
---#-----#-----#----------------------#
---#-----#----------------------------#
---#-----#----------------------------#
---#----------------------------------#
--#####################################
------------------#-------------------#
-----#------------#-------------------#
-----#------------#-------------------#
-----#-----#------#-------------------#
-----#-----#------#-------------------#
-----#-----#------#--------------@----#
-----#-----#--------------------------#
-----#-----#--------------------------#
#######################################
